0 0 0 0 0 0 0 0 0 0 0 0 
0 2 0 5 0 2 0 5 0 0 4 0 
0 1 1 0 2 5 2 0 1 0 1 0 
0 0 5 2 2 0 2 2 5 0 5 0 
0 1 1 0 2 0 2 0 1 0 1 0 
0 2 0 0 0 0 0 0 0 0 0 0 
0 0 0 0 0 1 0 0 0 0 4 0 
0 0 0 0 1 5 1 0 0 0 0 0 
0 1 0 1 5 0 5 1 0 2 5 0 
0 0 1 0 0 5 0 0 0 5 0 0 
0 1 0 0 2 0 2 0 0 2 5 0 
0 0 0 0 0 0 0 0 0 0 0 0 
 
 6 3 2