0 0 0 0 0 0 0 0 0 0 0 0 
0 3 5 3 2 0 0 1 0 5 4 0 
0 2 5 0 0 0 0 1 5 0 4 0 
0 0 2 0 2 2 0 0 1 1 4 0  
0 2 5 0 0 0 0 1 0 0 4 0 
0 0 0 0 4 2 0 1 0 0 4 0 
0 5 0 1 0 0 4 0 0 0 4 0 
0 0 0 1 0 0 0 0 0 1 0 0 
0 1 1 0 2 0 2 0 1 0 0 0 
0 0 0 1 0 0 0 0 0 1 0 0  
0 5 0 1 0 2 0 2 0 0 4 0  
0 0 0 0 0 0 0 0 0 0 0 0 

5 2 2 